Content/Graphics/tileSets/12x12x3 - tileSet.png
12;12
22;22;22;22;22;22;22;22;22;22;22;22
22;22;22;22;22;22;22;22;22;22;22;22
22;22;22;22;22;22;22;22;22;22;22;22
22;22;22;22;22;22;22;22;22;22;22;22
76;76;76;76;76;76;22;22;22;22;22;22
76;76;22;22;76;76;76;22;22;22;22;22
22;76;76;22;22;76;76;22;22;22;22;22
22;22;76;76;76;76;76;22;22;22;22;22
22;22;22;22;22;22;22;22;22;22;22;22
22;22;22;22;22;22;22;22;22;22;22;22
22;22;22;22;22;22;22;22;22;22;22;22
22;22;22;22;22;22;22;22;22;22;22;22
