12 12
22 22 22 22 22 22 22 22 22 22 22 22 
22 22 22 22 22 22 22 22 22 22 22 22 
22 22 22 22 22 22 22 22 22 22 22 22 
22 22 22 22 22 22 22 22 22 22 22 22 
76 76 76 76 76 76 22 22 22 22 22 22 
76 76 22 22 76 76 76 22 22 22 22 22 
22 76 76 22 22 76 76 22 22 22 22 22 
22 22 76 76 76 76 76 22 22 22 22 22 
22 22 22 22 22 22 22 22 22 22 22 22 
22 22 22 22 22 22 22 22 22 22 22 22 
22 22 22 22 22 22 22 22 22 22 22 22 
22 22 22 22 22 22 22 22 22 22 22 22 
